##.########
#......#..#
#...#.....#
#.........#
#...#......
..........#
#....##....
#....#....#
#.........#
#.#########
\robot 9 3
\robot 1 4