..........
....######
.........#
....######
..........
\robot 0 0
\robot 8 2