##.####.##
#...#....#
#.#.....##
##....#..#
#........#
##.##.####
\robot 2 0
\robot 5 0
\robot 5 2